WWWWWWWWWWWW
WWTEEWEEEETW
WWEMETEEWWWW
WWBEEBEEWWWW
WWEEEEBEWWWW
WWEEBEEEWWWW
WWWWTWWWWWWW
WWWWWWWWWWWW
WWWWWWWWWWWW
WWWWWWWWWWWW
WWWWWWWWWWWW
WWWWWWWWWWWW
