WWWWWWWWWWWW
WWWWWWWWWWWW
WWWWWWWWWWWW
WWWTEBMEWWWW
WWWWWEBTWWWW
WWWTWEBEWWWW
WWWEWETEWWWW
WWWBEEBBETWW
WWWEEETEEWWW
WWWWWWWWWWWW
WWWWWWWWWWWW
WWWWWWWWWWWW
