WWWWWWWWWWWW
WWBBBWEEEEEW
WWEEEEEEWWWW
WWEEEEEEWWWW
WWEEEEEEWWWW
WWEEEEEEWWWW
WWWWEEWWWWWW
WWWWWWWWWWWW
WWWWWWWWWWWW
WWWWWWWWWWWW
WWWWWWWWWWWW
WWWWWWWWWWWW
