WWWWWWWWWWWW
WWTEEWEEEEEW
WWEEEEEEWWWW
WWBEEEEEWWWW
WWEEEEBEWWWW
WWEEBBEEWWWW
WWWWEEWWWWWW
WWWWWWWWWWWW
WWWWWWWWWWWW
WWWWWWWWWWWW
WWWWWWWWWWWW
WWWWWWWWWWWW
